################################################################
#                                                              #
#                                                              #
#                                             #########        #
#                                                              # 
#                                                              #
#                   ###########                                # 
#                                                              #
#                                                              #
#                                                              #
#                                                              #
#                                                              #
#                                   #             #            #
#                                   #             #            #
#                                   #             #            #
#                                   ###############            #
#                                                              #
#                                                              #
#                                                              #
#           ############                                       #
#                                                              #
#                                                              #
################################################################