#############################        ###########################
#                                                              #
#            #      #                                          #
#            #      #                                          #
#            #      #                                          #
#            #      #                                          #
#            #      #                      #   #   #           #
#                                          #   #   #           #
#                                          #   #   #           #
                                           #   #   #            
                                           #   #   #            
                                                              
                                              
#                                                              #
#                                                              #
#                ################################              #
#                                                              #
#                                                              #
#                ################################              #
#                                                              #
#                                                              #
#                                                              #
#############################        ###########################